00000093
00100113
00400513
02800313
00000193
00418213
1011a023
10222023
00800713
00800293
00800693
00400793
00400493
00208433
02628063
00800633
10c2a023
1004a583
00858433
00428293
00448493
fe5ff3ef
00618863
1001a803
00418193
ff5ff3ef
